Country_ID,Country_ID_Alpha,Country_Name,Year,Total_Migrant_Population,Migrant_Male_Population,Migrant_Female_Population
108,BI,   Burundi,1990,333110,163267,169843
108,BI,   Burundi,1995,254853,124165,130688
108,BI,   Burundi,2000,125628,61094,64534
108,BI,   Burundi,2005,192774,94413,98361
108,BI,   Burundi,2010,247321,121762,125559
108,BI,   Burundi,2015,298299,146970,151329
108,BI,   Burundi,2020,344767,170125,174642
174,KM,   Comoros,1990,14079,6717,7362
174,KM,   Comoros,1995,13939,6614,7325
174,KM,   Comoros,2000,13799,6511,7288
174,KM,   Comoros,2005,13209,6286,6923
174,KM,   Comoros,2010,12618,6060,6558
174,KM,   Comoros,2015,12555,6071,6484
174,KM,   Comoros,2020,12496,6044,6452
262,DJ,   Djibouti,1990,122221,64242,57979
262,DJ,   Djibouti,1995,99774,52476,47298
262,DJ,   Djibouti,2000,100507,52920,47587
262,DJ,   Djibouti,2005,92110,51331,40779
262,DJ,   Djibouti,2010,102307,53669,48638
262,DJ,   Djibouti,2015,112351,59081,53270
262,DJ,   Djibouti,2020,119738,62863,56875
232,ER,   Eritrea,1990,11848,6228,5620
232,ER,   Eritrea,1995,12400,6542,5858
232,ER,   Eritrea,2000,12952,6856,6096
232,ER,   Eritrea,2005,15905,8603,7302
232,ER,   Eritrea,2010,15813,8679,7134
232,ER,   Eritrea,2015,15941,8833,7108
232,ER,   Eritrea,2020,13934,7815,6119
231,ET,   Ethiopia,1990,1155390,607284,548106
231,ET,   Ethiopia,1995,806904,424117,382787
231,ET,   Ethiopia,2000,611384,322219,289165
231,ET,   Ethiopia,2005,514451,269834,244617
231,ET,   Ethiopia,2010,568748,298069,270679
231,ET,   Ethiopia,2015,1161642,591409,570233
231,ET,   Ethiopia,2020,1085517,536807,548710
404,KE,   Kenya,1990,298089,161259,136830
404,KE,   Kenya,1995,618745,322189,296556
404,KE,   Kenya,2000,707852,352933,354919
404,KE,   Kenya,2005,773354,400364,372990
404,KE,   Kenya,2010,954925,473093,481832
404,KE,   Kenya,2015,1126886,562909,563977
404,KE,   Kenya,2020,1050147,529975,520172
450,MG,   Madagascar,1990,23917,13348,10569
450,MG,   Madagascar,1995,21177,11901,9276
450,MG,   Madagascar,2000,23541,13276,10265
450,MG,   Madagascar,2005,26058,14744,11314
450,MG,   Madagascar,2010,28905,16410,12495
450,MG,   Madagascar,2015,32075,18270,13805
450,MG,   Madagascar,2020,35563,20262,15301
454,MW,   Malawi,1990,1127724,546520,581204
454,MW,   Malawi,1995,241624,116198,125426
454,MW,   Malawi,2000,232620,111530,121090
454,MW,   Malawi,2005,221661,105931,115730
454,MW,   Malawi,2010,217722,103869,113853
454,MW,   Malawi,2015,197328,93689,103639
454,MW,   Malawi,2020,191362,93612,97750
480,MU,   Mauritius*,1990,3613,1763,1850
480,MU,   Mauritius*,1995,7493,3228,4265
480,MU,   Mauritius*,2000,15543,5705,9838
480,MU,   Mauritius*,2005,19647,8943,10704
480,MU,   Mauritius*,2010,24836,13188,11648
480,MU,   Mauritius*,2015,28585,15832,12753
480,MU,   Mauritius*,2020,28893,16003,12890
175,YT,   Mayotte*,1990,15229,8780,6449
175,YT,   Mayotte*,1995,26316,14679,11637
175,YT,   Mayotte*,2000,45474,23546,21928
175,YT,   Mayotte*,2005,63176,31364,31812
175,YT,   Mayotte*,2010,72757,34500,38257
175,YT,   Mayotte*,2015,81386,37657,43729
175,YT,   Mayotte*,2020,111540,51609,59931
508,MZ,   Mozambique,1990,122332,66060,56272
508,MZ,   Mozambique,1995,168256,91210,77046
508,MZ,   Mozambique,2000,195702,103175,92527
508,MZ,   Mozambique,2005,268694,130290,138404
508,MZ,   Mozambique,2010,306471,148105,158366
508,MZ,   Mozambique,2015,321794,155510,166284
508,MZ,   Mozambique,2020,338850,165490,173360
638,RE,   Réunion*,1990,57210,30724,26486
638,RE,   Réunion*,1995,77159,40710,36449
638,RE,   Réunion*,2000,100678,52264,48414
638,RE,   Réunion*,2005,115076,59196,55880
638,RE,   Réunion*,2010,123029,62707,60322
638,RE,   Réunion*,2015,127209,64537,62672
638,RE,   Réunion*,2020,131769,66852,64917
646,RW,   Rwanda,1990,160024,80763,79261
646,RW,   Rwanda,1995,215735,109783,105952
646,RW,   Rwanda,2000,347076,175741,171335
646,RW,   Rwanda,2005,423187,213279,209908
646,RW,   Rwanda,2010,426901,214048,212853
646,RW,   Rwanda,2015,514647,256327,258320
646,RW,   Rwanda,2020,513907,259907,254000
690,SC,   Seychelles,1990,3721,2204,1517
690,SC,   Seychelles,1995,5148,3021,2127
690,SC,   Seychelles,2000,6574,3837,2737
690,SC,   Seychelles,2005,8997,5820,3177
690,SC,   Seychelles,2010,11420,7804,3616
690,SC,   Seychelles,2015,12791,8954,3837
690,SC,   Seychelles,2020,13050,9136,3914
706,SO,   Somalia,1990,478294,244201,234093
706,SO,   Somalia,1995,19527,10282,9245
706,SO,   Somalia,2000,20097,10628,9469
706,SO,   Somalia,2005,20768,11098,9670
706,SO,   Somalia,2010,48106,25213,22893
706,SO,   Somalia,2015,40990,21584,19406
706,SO,   Somalia,2020,58590,32285,26305
728,SS,   South Sudan,1990,..,..,..
728,SS,   South Sudan,1995,..,..,..
728,SS,   South Sudan,2000,..,..,..
728,SS,   South Sudan,2005,..,..,..
728,SS,   South Sudan,2010,230732,119106,111626
728,SS,   South Sudan,2015,844112,430944,413168
728,SS,   South Sudan,2020,882252,443405,438847
800,UG,   Uganda,1990,544273,283337,260936
800,UG,   Uganda,1995,606987,308281,298706
800,UG,   Uganda,2000,584280,290859,293421
800,UG,   Uganda,2005,593308,292130,301178
800,UG,   Uganda,2010,492930,241903,251027
800,UG,   Uganda,2015,851175,415845,435330
800,UG,   Uganda,2020,1720313,827664,892649
834,TZ,   United Republic of Tanzania*,1990,574025,283390,290635
834,TZ,   United Republic of Tanzania*,1995,1106043,547089,558954
834,TZ,   United Republic of Tanzania*,2000,949600,481816,467784
834,TZ,   United Republic of Tanzania*,2005,771153,486983,284170
834,TZ,   United Republic of Tanzania*,2010,309847,154591,155256
834,TZ,   United Republic of Tanzania*,2015,384567,190617,193950
834,TZ,   United Republic of Tanzania*,2020,426017,213007,213010
894,ZM,   Zambia,1990,279463,143029,136434
894,ZM,   Zambia,1995,244338,125329,119009
894,ZM,   Zambia,2000,343703,175114,168589
894,ZM,   Zambia,2005,252895,128628,124267
894,ZM,   Zambia,2010,149962,75941,74021
894,ZM,   Zambia,2015,132107,66651,65456
894,ZM,   Zambia,2020,187955,97556,90399
716,ZW,   Zimbabwe,1990,634621,356240,278381
716,ZW,   Zimbabwe,1995,431226,246013,185213
716,ZW,   Zimbabwe,2000,410109,233881,176228
716,ZW,   Zimbabwe,2005,402226,229254,172972
716,ZW,   Zimbabwe,2010,398307,227201,171106
716,ZW,   Zimbabwe,2015,400482,225653,174829
716,ZW,   Zimbabwe,2020,416141,236561,179580
24,AO,   Angola,1990,33517,18142,15375
24,AO,   Angola,1995,39813,20755,19058
24,AO,   Angola,2000,46108,23367,22741
24,AO,   Angola,2005,62331,30736,31595
24,AO,   Angola,2010,336367,162332,174035
24,AO,   Angola,2015,632178,304635,327543
24,AO,   Angola,2020,656434,331401,325033
120,CM,   Cameroon,1990,265967,145869,120098
120,CM,   Cameroon,1995,244791,133945,110846
120,CM,   Cameroon,2000,227242,124008,103234
120,CM,   Cameroon,2005,265503,146129,119374
120,CM,   Cameroon,2010,291474,161485,129989
120,CM,   Cameroon,2015,508346,251311,257035
120,CM,   Cameroon,2020,579209,286254,292955
140,CF,   Central African Republic,1990,67234,35686,31548
140,CF,   Central African Republic,1995,99712,52975,46737
140,CF,   Central African Republic,2000,123529,65636,57893
140,CF,   Central African Republic,2005,96409,51299,45110
140,CF,   Central African Republic,2010,94685,50411,44274
140,CF,   Central African Republic,2015,81568,43147,38421
140,CF,   Central African Republic,2020,88546,46357,42189
148,TD,   Chad,1990,74342,40133,34209
148,TD,   Chad,1995,89584,48298,41286
148,TD,   Chad,2000,104825,56463,48362
148,TD,   Chad,2005,352130,159745,192385
148,TD,   Chad,2010,417034,186821,230213
148,TD,   Chad,2015,466968,215640,251328
148,TD,   Chad,2020,547494,249548,297946
178,CG,   Congo,1990,129391,64316,65075
178,CG,   Congo,1995,191635,95822,95813
178,CG,   Congo,2000,305880,153107,152773
178,CG,   Congo,2005,318724,173229,145495
178,CG,   Congo,2010,425173,231105,194068
178,CG,   Congo,2015,390142,213764,176378
178,CG,   Congo,2020,387606,211403,176203
180,CD,   Democratic Republic of the Congo,1990,754194,363117,391077
180,CD,   Democratic Republic of the Congo,1995,1816963,901379,915584
180,CD,   Democratic Republic of the Congo,2000,744387,365092,379295
180,CD,   Democratic Republic of the Congo,2005,623009,302359,320650
180,CD,   Democratic Republic of the Congo,2010,589882,284693,305189
180,CD,   Democratic Republic of the Congo,2015,810018,393966,416052
180,CD,   Democratic Republic of the Congo,2020,952871,459052,493819
226,GQ,   Equatorial Guinea,1990,2740,1465,1275
226,GQ,   Equatorial Guinea,1995,3629,1930,1699
226,GQ,   Equatorial Guinea,2000,4517,2394,2123
226,GQ,   Equatorial Guinea,2005,6588,3564,3024
226,GQ,   Equatorial Guinea,2010,8658,4734,3924
226,GQ,   Equatorial Guinea,2015,209611,161527,48084
226,GQ,   Equatorial Guinea,2020,230618,177716,52902
266,GA,   Gabon,1990,128188,73172,55016
266,GA,   Gabon,1995,171427,97800,73627
266,GA,   Gabon,2000,214431,122986,91445
266,GA,   Gabon,2005,233824,135107,98717
266,GA,   Gabon,2010,270829,158680,112149
266,GA,   Gabon,2015,378686,243782,134904
266,GA,   Gabon,2020,416651,268032,148619
678,ST,   Sao Tome and Principe,1990,5582,2953,2629
678,ST,   Sao Tome and Principe,1995,4936,2548,2388
678,ST,   Sao Tome and Principe,2000,4365,2212,2153
678,ST,   Sao Tome and Principe,2005,3433,1727,1706
678,ST,   Sao Tome and Principe,2010,2700,1352,1348
678,ST,   Sao Tome and Principe,2015,2394,1197,1197
678,ST,   Sao Tome and Principe,2020,2139,1067,1072
12,DZ,   Algeria,1990,273954,150234,123720
12,DZ,   Algeria,1995,262032,143696,118336
12,DZ,   Algeria,2000,250110,137158,112952
12,DZ,   Algeria,2005,197728,108434,89294
12,DZ,   Algeria,2010,217268,114894,102374
12,DZ,   Algeria,2015,239473,126522,112951
12,DZ,   Algeria,2020,250378,132142,118236
818,EG,   Egypt,1990,173833,91995,81838
818,EG,   Egypt,1995,166955,88545,78410
818,EG,   Egypt,2000,184774,98224,86550
818,EG,   Egypt,2005,285006,165211,119795
818,EG,   Egypt,2010,310017,174104,135913
818,EG,   Egypt,2015,353641,207433,146208
818,EG,   Egypt,2020,543937,289552,254385
434,LY,   Libya,1990,457075,242707,214368
434,LY,   Libya,1995,508041,300906,207135
434,LY,   Libya,2000,567436,368950,198486
434,LY,   Libya,2005,625412,445685,179727
434,LY,   Libya,2010,687192,491303,195889
434,LY,   Libya,2015,771146,549153,221993
434,LY,   Libya,2020,826537,593797,232740
504,MA,   Morocco,1990,54895,29024,25871
504,MA,   Morocco,1995,50360,26264,24096
504,MA,   Morocco,2000,53034,27233,25801
504,MA,   Morocco,2005,56222,28486,27736
504,MA,   Morocco,2010,71189,35881,35308
504,MA,   Morocco,2015,92424,46387,46037
504,MA,   Morocco,2020,102358,52707,49651
729,SD,   Sudan,1990,1402896,696385,706511
729,SD,   Sudan,1995,1053396,525701,527695
729,SD,   Sudan,2000,805086,404618,400468
729,SD,   Sudan,2005,546419,278084,268335
729,SD,   Sudan,2010,618709,314552,304157
729,SD,   Sudan,2015,620523,311885,308638
729,SD,   Sudan,2020,1379147,685177,693970
788,TN,   Tunisia,1990,37984,18900,19084
788,TN,   Tunisia,1995,37867,19045,18822
788,TN,   Tunisia,2000,36719,18679,18040
788,TN,   Tunisia,2005,35040,18000,17040
788,TN,   Tunisia,2010,43172,22236,20936
788,TN,   Tunisia,2015,56532,29253,27279
788,TN,   Tunisia,2020,60145,31474,28671
732,EH,   Western Sahara,1990,2688,1465,1223
732,EH,   Western Sahara,1995,2989,1651,1338
732,EH,   Western Sahara,2000,3289,1837,1452
732,EH,   Western Sahara,2005,3891,2224,1667
732,EH,   Western Sahara,2010,4493,2612,1881
732,EH,   Western Sahara,2015,5179,3059,2120
732,EH,   Western Sahara,2020,5424,3205,2219
72,BW,   Botswana,1990,27510,16614,10896
72,BW,   Botswana,1995,40168,23517,16651
72,BW,   Botswana,2000,74934,43840,31094
72,BW,   Botswana,2005,84661,49159,35502
72,BW,   Botswana,2010,94863,54019,40844
72,BW,   Botswana,2015,103053,58651,44402
72,BW,   Botswana,2020,110268,62817,47451
748,SZ,   Eswatini,1990,74991,39905,35086
748,SZ,   Eswatini,1995,35157,18701,16456
748,SZ,   Eswatini,2000,34084,17921,16163
748,SZ,   Eswatini,2005,33392,17369,16023
748,SZ,   Eswatini,2010,32637,16790,15847
748,SZ,   Eswatini,2015,32352,16627,15725
748,SZ,   Eswatini,2020,32858,16921,15937
426,LS,   Lesotho,1990,8240,4318,3922
426,LS,   Lesotho,1995,7204,3827,3377
426,LS,   Lesotho,2000,6167,3335,2832
426,LS,   Lesotho,2005,6290,3402,2888
426,LS,   Lesotho,2010,6414,3469,2945
426,LS,   Lesotho,2015,9152,5037,4115
426,LS,   Lesotho,2020,12060,6537,5523
516,NA,   Namibia,1990,120641,63748,56893
516,NA,   Namibia,1995,115372,61310,54062
516,NA,   Namibia,2000,135547,73154,62393
516,NA,   Namibia,2005,107347,57625,49722
516,NA,   Namibia,2010,103826,55803,48023
516,NA,   Namibia,2015,101618,54739,46879
516,NA,   Namibia,2020,109391,59024,50367
710,ZA,   South Africa,1990,1163883,717227,446656
710,ZA,   South Africa,1995,1003807,611083,392724
710,ZA,   South Africa,2000,1016963,607602,409361
710,ZA,   South Africa,2005,1351031,782272,568759
710,ZA,   South Africa,2010,2114801,1221739,893062
710,ZA,   South Africa,2015,3231728,1770914,1460814
710,ZA,   South Africa,2020,2860495,1627294,1233201
204,BJ,   Benin,1990,76751,40418,36333
204,BJ,   Benin,1995,105703,56304,49399
204,BJ,   Benin,2000,134655,72190,62465
204,BJ,   Benin,2005,248320,122368,125952
204,BJ,   Benin,2010,309225,143632,165593
204,BJ,   Benin,2015,366284,172056,194228
204,BJ,   Benin,2020,394276,185619,208657
854,BF,   Burkina Faso,1990,349652,167834,181818
854,BF,   Burkina Faso,1995,464104,223156,240948
854,BF,   Burkina Faso,2000,520363,250555,269808
854,BF,   Burkina Faso,2005,597658,285871,311787
854,BF,   Burkina Faso,2010,674438,320939,353499
854,BF,   Burkina Faso,2015,704676,335328,369348
854,BF,   Burkina Faso,2020,723989,344331,379658
132,CV,   Cabo Verde,1990,8931,4429,4502
132,CV,   Cabo Verde,1995,9979,5091,4888
132,CV,   Cabo Verde,2000,11027,5753,5274
132,CV,   Cabo Verde,2005,12700,6523,6177
132,CV,   Cabo Verde,2010,14373,7293,7080
132,CV,   Cabo Verde,2015,14924,7547,7377
132,CV,   Cabo Verde,2020,15788,7985,7803
384,CI,   Côte d'Ivoire,1990,1816426,1011749,804677
384,CI,   Côte d'Ivoire,1995,2076394,1150710,925684
384,CI,   Côte d'Ivoire,2000,2163644,1198496,965148
384,CI,   Côte d'Ivoire,2005,2265090,1254690,1010400
384,CI,   Côte d'Ivoire,2010,2366537,1310459,1056078
384,CI,   Côte d'Ivoire,2015,2470613,1368110,1102503
384,CI,   Côte d'Ivoire,2020,2564857,1420248,1144609
270,GM,   Gambia,1990,118123,66306,51817
270,GM,   Gambia,1995,150890,82048,68842
270,GM,   Gambia,2000,182514,97138,85376
270,GM,   Gambia,2005,181839,96196,85643
270,GM,   Gambia,2010,185837,98123,87714
270,GM,   Gambia,2015,192540,101501,91039
270,GM,   Gambia,2020,215659,113766,101893
288,GH,   Ghana,1990,164851,83030,81821
288,GH,   Ghana,1995,252879,127423,125456
288,GH,   Ghana,2000,191601,97279,94322
288,GH,   Ghana,2005,309932,159527,150405
288,GH,   Ghana,2010,337766,180030,157736
288,GH,   Ghana,2015,414744,221026,193718
288,GH,   Ghana,2020,476412,254403,222009
324,GN,   Guinea,1990,403621,201260,202361
324,GN,   Guinea,1995,774505,386537,387968
324,GN,   Guinea,2000,560075,279108,280967
324,GN,   Guinea,2005,233419,113528,119891
324,GN,   Guinea,2010,178762,93267,85495
324,GN,   Guinea,2015,126657,74193,52464
324,GN,   Guinea,2020,121437,71385,50052
624,GW,   Guinea-Bissau,1990,15368,7689,7679
624,GW,   Guinea-Bissau,1995,27961,13833,14128
624,GW,   Guinea-Bissau,2000,20450,10155,10295
624,GW,   Guinea-Bissau,2005,20902,10380,10522
624,GW,   Guinea-Bissau,2010,21391,10463,10928
624,GW,   Guinea-Bissau,2015,22333,10826,11507
624,GW,   Guinea-Bissau,2020,17945,8867,9078
430,LR,   Liberia,1990,94964,53924,41040
430,LR,   Liberia,1995,208563,111647,96916
430,LR,   Liberia,2000,151868,82129,69739
430,LR,   Liberia,2005,87217,51197,36020
430,LR,   Liberia,2010,99165,56902,42263
430,LR,   Liberia,2015,112111,64079,48032
430,LR,   Liberia,2020,87947,50694,37253
466,ML,   Mali,1990,160736,82049,78687
466,ML,   Mali,1995,176187,90871,85316
466,ML,   Mali,2000,189475,97752,91723
466,ML,   Mali,2005,258630,133344,125286
466,ML,   Mali,2010,341078,173088,167990
466,ML,   Mali,2015,420504,213218,207286
466,ML,   Mali,2020,485829,246308,239521
478,MR,   Mauritania,1990,111650,57569,54081
478,MR,   Mauritania,1995,89562,47015,42547
478,MR,   Mauritania,2000,57366,31163,26203
478,MR,   Mauritania,2005,58211,32642,25569
478,MR,   Mauritania,2010,84920,48746,36174
478,MR,   Mauritania,2015,166552,94070,72482
478,MR,   Mauritania,2020,182286,103203,79083
562,NE,   Niger,1990,115464,55222,60242
562,NE,   Niger,1995,145999,69751,76248
562,NE,   Niger,2000,122260,58192,64068
562,NE,   Niger,2005,124509,59194,65315
562,NE,   Niger,2010,126482,60042,66440
562,NE,   Niger,2015,252998,119915,133083
562,NE,   Niger,2020,348056,162019,186037
566,NG,   Nigeria,1990,456621,256166,200455
566,NG,   Nigeria,1995,462999,258091,204908
566,NG,   Nigeria,2000,487882,270211,217671
566,NG,   Nigeria,2005,969714,564612,405102
566,NG,   Nigeria,2010,990494,576648,413846
566,NG,   Nigeria,2015,1199115,657887,541228
566,NG,   Nigeria,2020,1308568,713678,594890
654,SH,   Saint Helena*,1990,178,110,68
654,SH,   Saint Helena*,1995,117,70,47
654,SH,   Saint Helena*,2000,108,61,47
654,SH,   Saint Helena*,2005,163,85,78
654,SH,   Saint Helena*,2010,248,136,112
654,SH,   Saint Helena*,2015,377,251,126
654,SH,   Saint Helena*,2020,437,306,131
686,SN,   Senegal,1990,270410,138840,131570
686,SN,   Senegal,1995,287654,147165,140489
686,SN,   Senegal,2000,231901,121492,110409
686,SN,   Senegal,2005,238298,124854,113444
686,SN,   Senegal,2010,256092,135879,120213
686,SN,   Senegal,2015,266496,141402,125094
686,SN,   Senegal,2020,274929,145591,129338
694,SL,   Sierra Leone,1990,222148,122898,99250
694,SL,   Sierra Leone,1995,98516,55937,42579
694,SL,   Sierra Leone,2000,97974,54184,43790
694,SL,   Sierra Leone,2005,146227,76709,69518
694,SL,   Sierra Leone,2010,79265,43622,35643
694,SL,   Sierra Leone,2015,58830,33077,25753
694,SL,   Sierra Leone,2020,53746,30408,23338
768,TG,   Togo,1990,84844,42903,41941
768,TG,   Togo,1995,101583,50727,50856
768,TG,   Togo,2000,137968,69112,68856
768,TG,   Togo,2005,204219,103233,100986
768,TG,   Togo,2010,255564,129424,126140
768,TG,   Togo,2015,277384,139540,137844
768,TG,   Togo,2020,279936,141807,138129
398,KZ,   Kazakhstan,1990,3619200,1666164,1953036
398,KZ,   Kazakhstan,1995,3251968,1497455,1754513
398,KZ,   Kazakhstan,2000,2874194,1323580,1550614
398,KZ,   Kazakhstan,2005,3103027,1472820,1630207
398,KZ,   Kazakhstan,2010,3334937,1625155,1709782
398,KZ,   Kazakhstan,2015,3546060,1757828,1788232
398,KZ,   Kazakhstan,2020,3732073,1850097,1881976
417,KG,   Kyrgyzstan,1990,623083,260416,362667
417,KG,   Kyrgyzstan,1995,518338,216638,301700
417,KG,   Kyrgyzstan,2000,389824,162927,226897
417,KG,   Kyrgyzstan,2005,309399,128064,181335
417,KG,   Kyrgyzstan,2010,232065,94596,137469
417,KG,   Kyrgyzstan,2015,204382,82616,121766
417,KG,   Kyrgyzstan,2020,199011,80456,118555
762,TJ,   Tajikistan,1990,428900,187972,240928
762,TJ,   Tajikistan,1995,348347,151894,196453
762,TJ,   Tajikistan,2000,299499,131653,167846
762,TJ,   Tajikistan,2005,280466,121403,159063
762,TJ,   Tajikistan,2010,279808,121780,158028
762,TJ,   Tajikistan,2015,275101,118639,156462
762,TJ,   Tajikistan,2020,276031,119174,156857
795,TM,   Turkmenistan,1990,306500,134174,172326
795,TM,   Turkmenistan,1995,273565,132122,141443
795,TM,   Turkmenistan,2000,219067,102810,116257
795,TM,   Turkmenistan,2005,213053,101214,111839
795,TM,   Turkmenistan,2010,197979,90634,107345
795,TM,   Turkmenistan,2015,196376,91531,104845
795,TM,   Turkmenistan,2020,194920,92357,102563
860,UZ,   Uzbekistan,1990,1653000,723618,929382
860,UZ,   Uzbekistan,1995,1512577,657490,855087
860,UZ,   Uzbekistan,2000,1406498,606163,800335
860,UZ,   Uzbekistan,2005,1329932,589690,740242
860,UZ,   Uzbekistan,2010,1220149,558379,661770
860,UZ,   Uzbekistan,2015,1170873,545721,625152
860,UZ,   Uzbekistan,2020,1162007,543364,618643
156,CN,   China*,1990,376361,191954,184407
156,CN,   China*,1995,442198,223018,219180
156,CN,   China*,2000,508034,254082,253952
156,CN,   China*,2005,678947,379920,299027
156,CN,   China*,2010,849861,505758,344103
156,CN,   China*,2015,978046,600136,377910
156,CN,   China*,2020,1039675,637952,401723
344,HK,"   China, Hong Kong SAR*",1990,2218473,1124544,1093929
344,HK,"   China, Hong Kong SAR*",1995,2443798,1175087,1268711
344,HK,"   China, Hong Kong SAR*",2000,2669122,1225629,1443493
344,HK,"   China, Hong Kong SAR*",2005,2721235,1185121,1536114
344,HK,"   China, Hong Kong SAR*",2010,2779950,1147539,1632411
344,HK,"   China, Hong Kong SAR*",2015,2841113,1120982,1720131
344,HK,"   China, Hong Kong SAR*",2020,2962492,1107970,1854522
446,MO,"   China, Macao SAR*",1990,205047,96379,108668
446,MO,"   China, Macao SAR*",1995,224929,103660,121269
446,MO,"   China, Macao SAR*",2000,240791,109391,131400
446,MO,"   China, Macao SAR*",2005,279308,130387,148921
446,MO,"   China, Macao SAR*",2010,318506,146407,172099
446,MO,"   China, Macao SAR*",2015,376066,174589,201477
446,MO,"   China, Macao SAR*",2020,403490,187321,216169
158,TW,"   China, Taiwan Province of China*",1990,..,..,..
158,TW,"   China, Taiwan Province of China*",1995,..,..,..
158,TW,"   China, Taiwan Province of China*",2000,..,..,..
158,TW,"   China, Taiwan Province of China*",2005,..,..,..
158,TW,"   China, Taiwan Province of China*",2010,..,..,..
158,TW,"   China, Taiwan Province of China*",2015,..,..,..
158,TW,"   China, Taiwan Province of China*",2020,..,..,..
408,KP,   Dem. People's Republic of Korea,1990,34103,17393,16710
408,KP,   Dem. People's Republic of Korea,1995,35143,17562,17581
408,KP,   Dem. People's Republic of Korea,2000,36183,17731,18452
408,KP,   Dem. People's Republic of Korea,2005,40097,19749,20348
408,KP,   Dem. People's Republic of Korea,2010,44010,21766,22244
408,KP,   Dem. People's Republic of Korea,2015,48458,24110,24348
408,KP,   Dem. People's Republic of Korea,2020,49549,24654,24895
392,JP,   Japan,1990,1075317,538765,536552
392,JP,   Japan,1995,1362371,680212,682159
392,JP,   Japan,2000,1686444,796928,889516
392,JP,   Japan,2005,2011555,931198,1080357
392,JP,   Japan,2010,2134151,972481,1161670
392,JP,   Japan,2015,2232189,1050070,1182119
392,JP,   Japan,2020,2770996,1347156,1423840
496,MN,   Mongolia,1990,6718,3419,3299
496,MN,   Mongolia,1995,7424,3959,3465
496,MN,   Mongolia,2000,8206,4564,3642
496,MN,   Mongolia,2005,11477,7577,3900
496,MN,   Mongolia,2010,16062,11880,4182
496,MN,   Mongolia,2015,19886,13284,6602
496,MN,   Mongolia,2020,21345,14263,7082
410,KR,   Republic of Korea,1990,43247,24349,18898
410,KR,   Republic of Korea,1995,123886,70758,53128
410,KR,   Republic of Korea,2000,244224,143212,101012
410,KR,   Republic of Korea,2005,486065,284305,201760
410,KR,   Republic of Korea,2010,919987,515503,404484
410,KR,   Republic of Korea,2015,1370905,760957,609948
410,KR,   Republic of Korea,2020,1728182,958365,769817
96,BN,   Brunei Darussalam,1990,73200,41856,31344
96,BN,   Brunei Darussalam,1995,84748,47832,36916
96,BN,   Brunei Darussalam,2000,96296,53807,42489
96,BN,   Brunei Darussalam,2005,98441,55265,43176
96,BN,   Brunei Darussalam,2010,100587,56723,43864
96,BN,   Brunei Darussalam,2015,102733,58181,44552
96,BN,   Brunei Darussalam,2020,111959,63407,48552
116,KH,   Cambodia,1990,38375,19084,19291
116,KH,   Cambodia,1995,92230,45361,46869
116,KH,   Cambodia,2000,146085,71638,74447
116,KH,   Cambodia,2005,114096,57545,56551
116,KH,   Cambodia,2010,82028,43412,38616
116,KH,   Cambodia,2015,73962,39854,34108
116,KH,   Cambodia,2020,79341,42730,36611
360,ID,   Indonesia,1990,465612,229885,235727
360,ID,   Indonesia,1995,378960,191600,187360
360,ID,   Indonesia,2000,292307,153315,138992
360,ID,   Indonesia,2005,289310,165287,124023
360,ID,   Indonesia,2010,307487,176522,130965
360,ID,   Indonesia,2015,338124,196717,141407
360,ID,   Indonesia,2020,355505,206538,148967
418,LA,   Lao People's Democratic Republic,1990,22866,11806,11060
418,LA,   Lao People's Democratic Republic,1995,23526,12199,11327
418,LA,   Lao People's Democratic Republic,2000,21948,11564,10384
418,LA,   Lao People's Democratic Republic,2005,20371,10930,9441
418,LA,   Lao People's Democratic Republic,2010,32955,20133,12822
418,LA,   Lao People's Democratic Republic,2015,45538,29335,16203
418,LA,   Lao People's Democratic Republic,2020,48731,31393,17338
458,MY,   Malaysia*,1990,695920,405808,290112
458,MY,   Malaysia*,1995,937368,534964,402404
458,MY,   Malaysia*,2000,1463598,822679,640919
458,MY,   Malaysia*,2005,1918504,1133541,784963
458,MY,   Malaysia*,2010,2417395,1469977,947418
458,MY,   Malaysia*,2015,3280681,1996220,1284461
458,MY,   Malaysia*,2020,3476560,2156265,1320295
104,MM,   Myanmar,1990,133545,72310,61235
104,MM,   Myanmar,1995,113663,61489,52174
104,MM,   Myanmar,2000,98011,52150,45861
104,MM,   Myanmar,2005,83025,44506,38519
104,MM,   Myanmar,2010,76414,41574,34840
104,MM,   Myanmar,2015,73309,40178,33131
104,MM,   Myanmar,2020,76446,41898,34548
608,PH,   Philippines,1990,154071,81347,72724
608,PH,   Philippines,1995,207345,107524,99821
608,PH,   Philippines,2000,318095,161904,156191
608,PH,   Philippines,2005,257468,133023,124445
608,PH,   Philippines,2010,208599,107933,100666
608,PH,   Philippines,2015,211862,109783,102079
608,PH,   Philippines,2020,225525,117105,108420
702,SG,   Singapore,1990,727262,345842,381420
702,SG,   Singapore,1995,991492,456411,535081
702,SG,   Singapore,2000,1351691,601671,750020
702,SG,   Singapore,2005,1710594,758762,951832
702,SG,   Singapore,2010,2164794,956856,1207938
702,SG,   Singapore,2015,2483405,1096394,1387011
702,SG,   Singapore,2020,2523648,1112517,1411131
764,TH,   Thailand,1990,528693,283486,245207
764,TH,   Thailand,1995,809720,426290,383430
764,TH,   Thailand,2000,1257821,647728,610093
764,TH,   Thailand,2005,2195610,1102248,1093362
764,TH,   Thailand,2010,3234381,1629881,1604500
764,TH,   Thailand,2015,3470220,1742708,1727512
764,TH,   Thailand,2020,3632496,1821857,1810639
626,TL,   Timor-Leste,1990,8954,4450,4504
626,TL,   Timor-Leste,1995,9743,4763,4980
626,TL,   Timor-Leste,2000,10602,5095,5507
626,TL,   Timor-Leste,2005,11286,5578,5708
626,TL,   Timor-Leste,2010,11540,5837,5703
626,TL,   Timor-Leste,2015,8520,5148,3372
626,TL,   Timor-Leste,2020,8399,5076,3323
704,VN,   Viet Nam,1990,28118,15230,12888
704,VN,   Viet Nam,1995,51262,28187,23075
704,VN,   Viet Nam,2000,56754,32825,23929
704,VN,   Viet Nam,2005,51768,31106,20662
704,VN,   Viet Nam,2010,61756,35971,25785
704,VN,   Viet Nam,2015,72793,42168,30625
704,VN,   Viet Nam,2020,76767,44471,32296
4,AF,   Afghanistan,1990,57686,32558,25128
4,AF,   Afghanistan,1995,71522,39105,32417
4,AF,   Afghanistan,2000,75917,42848,33069
4,AF,   Afghanistan,2005,87314,49281,38033
4,AF,   Afghanistan,2010,102276,57726,44550
4,AF,   Afghanistan,2015,339432,171550,167882
4,AF,   Afghanistan,2020,144098,69189,74909
50,BD,   Bangladesh,1990,881617,476097,405520
50,BD,   Bangladesh,1995,934735,503989,430746
50,BD,   Bangladesh,2000,987853,531907,455946
50,BD,   Bangladesh,2005,1062270,572146,490124
50,BD,   Bangladesh,2010,1345546,710548,634998
50,BD,   Bangladesh,2015,1422179,751741,670438
50,BD,   Bangladesh,2020,2115408,1093978,1021430
64,BT,   Bhutan,1990,23807,19409,4398
64,BT,   Bhutan,1995,27972,22804,5168
64,BT,   Bhutan,2000,32137,26200,5937
64,BT,   Bhutan,2005,40279,32742,7537
64,BT,   Bhutan,2010,48420,39283,9137
64,BT,   Bhutan,2015,51106,43396,7710
64,BT,   Bhutan,2020,53612,45524,8088
356,IN,   India,1990,7594801,3967470,3627331
356,IN,   India,1995,6952238,3608978,3343260
356,IN,   India,2000,6411331,3303591,3107740
356,IN,   India,2005,5936740,2931489,3005251
356,IN,   India,2010,5574018,2699495,2874523
356,IN,   India,2015,5210847,2474515,2736332
356,IN,   India,2020,4878704,2273912,2604792
364,IR,   Iran (Islamic Republic of),1990,4291601,2369093,1922508
364,IR,   Iran (Islamic Republic of),1995,2937668,1612428,1325240
364,IR,   Iran (Islamic Republic of),2000,2476469,1365390,1111079
364,IR,   Iran (Islamic Republic of),2005,2552206,1401736,1150470
364,IR,   Iran (Islamic Republic of),2010,2722397,1490419,1231978
364,IR,   Iran (Islamic Republic of),2015,2729939,1487403,1242536
364,IR,   Iran (Islamic Republic of),2020,2797235,1517518,1279717
462,MV,   Maldives,1990,8689,4777,3912
462,MV,   Maldives,1995,18510,9243,9267
462,MV,   Maldives,2000,27092,14907,12185
462,MV,   Maldives,2005,45045,27079,17966
462,MV,   Maldives,2010,54659,41712,12947
462,MV,   Maldives,2015,64273,56345,7928
462,MV,   Maldives,2020,70079,61437,8642
524,NP,   Nepal,1990,429974,125966,304008
524,NP,   Nepal,1995,690225,217088,473137
524,NP,   Nepal,2000,717900,241959,475941
524,NP,   Nepal,2005,680729,235852,444877
524,NP,   Nepal,2010,581889,191167,390722
524,NP,   Nepal,2015,509471,156361,353110
524,NP,   Nepal,2020,487564,146930,340634
586,PK,   Pakistan,1990,6208204,3264380,2943824
586,PK,   Pakistan,1995,3669308,1951223,1718085
586,PK,   Pakistan,2000,4181912,2249960,1931952
586,PK,   Pakistan,2005,3174558,1710343,1464215
586,PK,   Pakistan,2010,3943681,2075512,1868169
586,PK,   Pakistan,2015,3506520,1845470,1661050
586,PK,   Pakistan,2020,3276580,1812804,1463776
144,LK,   Sri Lanka,1990,41561,23423,18138
144,LK,   Sri Lanka,1995,40841,22689,18152
144,LK,   Sri Lanka,2000,40132,21971,18161
144,LK,   Sri Lanka,2005,39526,21318,18208
144,LK,   Sri Lanka,2010,38959,20694,18265
144,LK,   Sri Lanka,2015,39706,20745,18961
144,LK,   Sri Lanka,2020,40254,21196,19058
51,AM,   Armenia,1990,658789,270535,388254
51,AM,   Armenia,1995,693999,284995,409004
51,AM,   Armenia,2000,657900,270170,387730
51,AM,   Armenia,2005,469189,191432,277757
51,AM,   Armenia,2010,211147,85669,125478
51,AM,   Armenia,2015,191199,77436,113763
51,AM,   Armenia,2020,190349,78085,112264
31,AZ,   Azerbaijan*,1990,360600,157856,202744
31,AZ,   Azerbaijan*,1995,344070,149509,194561
31,AZ,   Azerbaijan*,2000,327540,141161,186379
31,AZ,   Azerbaijan*,2005,301834,135143,166691
31,AZ,   Azerbaijan*,2010,276901,129512,147389
31,AZ,   Azerbaijan*,2015,264359,126656,137703
31,AZ,   Azerbaijan*,2020,252228,121007,131221
48,BH,   Bahrain,1990,173212,122730,50482
48,BH,   Bahrain,1995,205979,144227,61752
48,BH,   Bahrain,2000,239361,165344,74017
48,BH,   Bahrain,2005,404018,288614,115404
48,BH,   Bahrain,2010,666406,481344,185062
48,BH,   Bahrain,2015,722487,529546,192941
48,BH,   Bahrain,2020,936094,694238,241856
196,CY,   Cyprus*,1990,43805,20463,23342
196,CY,   Cyprus*,1995,61941,27604,34337
196,CY,   Cyprus*,2000,80076,34745,45331
196,CY,   Cyprus*,2005,122849,53532,69317
196,CY,   Cyprus*,2010,188472,82477,105995
196,CY,   Cyprus*,2015,176693,77357,99336
196,CY,   Cyprus*,2020,190366,85679,104687
268,GE,   Georgia*,1990,304470,133285,171185
268,GE,   Georgia*,1995,152235,66643,85592
268,GE,   Georgia*,2000,76117,33321,42796
268,GE,   Georgia*,2005,71296,31215,40081
268,GE,   Georgia*,2010,73078,31993,41085
268,GE,   Georgia*,2015,76685,33570,43115
268,GE,   Georgia*,2020,79368,34879,44489
368,IQ,   Iraq,1990,83638,55751,27887
368,IQ,   Iraq,1995,199460,114821,84639
368,IQ,   Iraq,2000,210525,120464,90061
368,IQ,   Iraq,2005,134863,81877,52986
368,IQ,   Iraq,2010,120466,74535,45931
368,IQ,   Iraq,2015,359352,209217,150135
368,IQ,   Iraq,2020,365766,201427,164339
376,IL,   Israel,1990,1632704,770777,861927
376,IL,   Israel,1995,1792185,830330,961855
376,IL,   Israel,2000,1851309,853712,997597
376,IL,   Israel,2005,1889503,867805,1021698
376,IL,   Israel,2010,1956190,892887,1063303
376,IL,   Israel,2015,2011727,912899,1098828
376,IL,   Israel,2020,1953575,886517,1067058
400,JO,   Jordan,1990,1146349,586473,559876
400,JO,   Jordan,1995,1537097,784725,752372
400,JO,   Jordan,2000,1927845,982977,944868
400,JO,   Jordan,2005,2198740,1119171,1079569
400,JO,   Jordan,2010,2786853,1416784,1370069
400,JO,   Jordan,2015,3166961,1594808,1572153
400,JO,   Jordan,2020,3457691,1756637,1701054
414,KW,   Kuwait,1990,1074391,654878,419513
414,KW,   Kuwait,1995,921954,591452,330502
414,KW,   Kuwait,2000,1127640,761512,366128
414,KW,   Kuwait,2005,1333530,918718,414812
414,KW,   Kuwait,2010,1874812,1312111,562701
414,KW,   Kuwait,2015,2866136,1901855,964281
414,KW,   Kuwait,2020,3110159,2063430,1046729
422,LB,   Lebanon,1990,523693,267922,255771
422,LB,   Lebanon,1995,608303,310613,297690
422,LB,   Lebanon,2000,692913,353305,339608
422,LB,   Lebanon,2005,742243,382830,359413
422,LB,   Lebanon,2010,793191,413057,380134
422,LB,   Lebanon,2015,1916259,921661,994598
422,LB,   Lebanon,2020,1712762,839706,873056
512,OM,   Oman,1990,304000,242477,61523
512,OM,   Oman,1995,539643,417444,122199
512,OM,   Oman,2000,623608,488389,135219
512,OM,   Oman,2005,666164,527845,138319
512,OM,   Oman,2010,816234,658753,157481
512,OM,   Oman,2015,1856226,1552000,304226
512,OM,   Oman,2020,2372836,1984025,388811
634,QA,   Qatar,1990,309753,225932,83821
634,QA,   Qatar,1995,361673,269972,91701
634,QA,   Qatar,2000,359697,274242,85455
634,QA,   Qatar,2005,646026,498428,147598
634,QA,   Qatar,2010,1456413,1206571,249842
634,QA,   Qatar,2015,1687640,1416361,271279
634,QA,   Qatar,2020,2226192,1842785,383407
682,SA,   Saudi Arabia,1990,4998445,3324873,1673572
682,SA,   Saudi Arabia,1995,5122702,3416485,1706217
682,SA,   Saudi Arabia,2000,5263387,3517768,1745619
682,SA,   Saudi Arabia,2005,6501819,4469805,2032014
682,SA,   Saudi Arabia,2010,8429956,5933281,2496675
682,SA,   Saudi Arabia,2015,10771366,7461502,3309864
682,SA,   Saudi Arabia,2020,13454842,9235130,4219712
275,PS,   State of Palestine*,1990,288332,132101,156231
275,PS,   State of Palestine*,1995,281767,128328,153439
275,PS,   State of Palestine*,2000,275202,124555,150647
275,PS,   State of Palestine*,2005,274520,124608,149912
275,PS,   State of Palestine*,2010,273840,124660,149180
275,PS,   State of Palestine*,2015,273163,124710,148453
275,PS,   State of Palestine*,2020,272784,124737,148047
760,SY,   Syrian Arab Republic,1990,714140,364077,350063
760,SY,   Syrian Arab Republic,1995,830610,423115,407495
760,SY,   Syrian Arab Republic,2000,834916,427981,406935
760,SY,   Syrian Arab Republic,2005,882398,452524,429874
760,SY,   Syrian Arab Republic,2010,1783595,910982,872613
760,SY,   Syrian Arab Republic,2015,835716,426967,408749
760,SY,   Syrian Arab Republic,2020,868711,432279,436432
792,TR,   Turkey,1990,1163686,577329,586357
792,TR,   Turkey,1995,1216173,593938,622235
792,TR,   Turkey,2000,1280963,616007,664956
792,TR,   Turkey,2005,1324108,621694,702414
792,TR,   Turkey,2010,1373749,629868,743881
792,TR,   Turkey,2015,4346197,2390166,1956031
792,TR,   Turkey,2020,6052652,3124165,2928487
784,AE,   United Arab Emirates,1990,1306574,931959,374615
784,AE,   United Arab Emirates,1995,1824118,1309868,514250
784,AE,   United Arab Emirates,2000,2447010,1757200,689810
784,AE,   United Arab Emirates,2005,3281115,2388299,892816
784,AE,   United Arab Emirates,2010,7316697,5463446,1853251
784,AE,   United Arab Emirates,2015,7995126,5890170,2104956
784,AE,   United Arab Emirates,2020,8716332,6419792,2296540
887,YE,   Yemen,1990,118863,67010,51853
887,YE,   Yemen,1995,136515,77832,58683
887,YE,   Yemen,2000,144940,80514,64426
887,YE,   Yemen,2005,171871,98879,72992
887,YE,   Yemen,2010,288394,156123,132271
887,YE,   Yemen,2015,379882,199390,180492
887,YE,   Yemen,2020,387113,223512,163601
112,BY,   Belarus,1990,1248977,572021,676956
112,BY,   Belarus,1995,1186282,543307,642975
112,BY,   Belarus,2000,1123586,514593,608993
112,BY,   Belarus,2005,1106982,506988,599994
112,BY,   Belarus,2010,1090378,499384,590994
112,BY,   Belarus,2015,1082905,495961,586944
112,BY,   Belarus,2020,1067090,488713,578377
100,BG,   Bulgaria,1990,21510,9047,12463
100,BG,   Bulgaria,1995,32435,13642,18793
100,BG,   Bulgaria,2000,43360,18238,25122
100,BG,   Bulgaria,2005,61074,26594,34480
100,BG,   Bulgaria,2010,76287,33841,42446
100,BG,   Bulgaria,2015,123803,60058,63745
100,BG,   Bulgaria,2020,184363,91585,92778
203,CZ,   Czechia,1990,110394,57405,52989
203,CZ,   Czechia,1995,165592,88316,77276
203,CZ,   Czechia,2000,220789,119227,101562
203,CZ,   Czechia,2005,322540,181719,140821
203,CZ,   Czechia,2010,398493,236160,162333
203,CZ,   Czechia,2015,416454,239228,177226
203,CZ,   Czechia,2020,540921,312941,227980
348,HU,   Hungary,1990,347510,156185,191325
348,HU,   Hungary,1995,322234,147202,175032
348,HU,   Hungary,2000,296957,138219,158738
348,HU,   Hungary,2005,366787,174216,192571
348,HU,   Hungary,2010,436616,210212,226404
348,HU,   Hungary,2015,475508,235719,239789
348,HU,   Hungary,2020,584567,303065,281502
616,PL,   Poland,1990,1127771,482176,645595
616,PL,   Poland,1995,964725,404049,560676
616,PL,   Poland,2000,825251,338323,486928
616,PL,   Poland,2005,722509,297039,425470
616,PL,   Poland,2010,642417,262263,380154
616,PL,   Poland,2015,611855,256623,355232
616,PL,   Poland,2020,817254,390449,426805
498,MD,   Republic of Moldova*,1990,544162,238053,306109
498,MD,   Republic of Moldova*,1995,367231,155297,211934
498,MD,   Republic of Moldova*,2000,247828,101097,146731
498,MD,   Republic of Moldova*,2005,171122,67924,103198
498,MD,   Republic of Moldova*,2010,129488,52198,77290
498,MD,   Republic of Moldova*,2015,106374,43467,62907
498,MD,   Republic of Moldova*,2020,104438,42743,61695
642,RO,   Romania,1990,135825,57601,78224
642,RO,   Romania,1995,135037,60443,74594
642,RO,   Romania,2000,134254,63121,71133
642,RO,   Romania,2005,145162,70153,75009
642,RO,   Romania,2010,177211,87667,89544
642,RO,   Romania,2015,281048,146758,134290
642,RO,   Romania,2020,705310,386946,318364
643,RU,   Russian Federation,1990,11524948,5655422,5869526
643,RU,   Russian Federation,1995,11928927,5925452,6003475
643,RU,   Russian Federation,2000,11900297,5982851,5917446
643,RU,   Russian Federation,2005,11667588,5806597,5860991
643,RU,   Russian Federation,2010,11194710,5514401,5680309
643,RU,   Russian Federation,2015,11643276,5715211,5928065
643,RU,   Russian Federation,2020,11636911,5712089,5924822
703,SK,   Slovakia,1990,41295,18187,23108
703,SK,   Slovakia,1995,69323,30531,38792
703,SK,   Slovakia,2000,116376,51253,65123
703,SK,   Slovakia,2005,130491,58716,71775
703,SK,   Slovakia,2010,146319,66938,79381
703,SK,   Slovakia,2015,177624,89011,88613
703,SK,   Slovakia,2020,197161,100551,96610
804,UA,   Ukraine*,1990,6892920,2953603,3939317
804,UA,   Ukraine*,1995,6172338,2644845,3527493
804,UA,   Ukraine*,2000,5527087,2368364,3158723
804,UA,   Ukraine*,2005,5050302,2168060,2882242
804,UA,   Ukraine*,2010,4818767,2072474,2746293
804,UA,   Ukraine*,2015,4915142,2113924,2801218
804,UA,   Ukraine*,2020,4997387,2149298,2848089
208,DK,   Denmark*,1990,235189,114411,120778
208,DK,   Denmark*,1995,303108,147194,155914
208,DK,   Denmark*,2000,371026,179977,191049
208,DK,   Denmark*,2005,440383,213097,227286
208,DK,   Denmark*,2010,500772,242029,258743
208,DK,   Denmark*,2015,595876,291431,304445
208,DK,   Denmark*,2020,717574,354476,363098
233,EE,   Estonia,1990,381997,171691,210306
233,EE,   Estonia,1995,315755,136268,179487
233,EE,   Estonia,2000,249512,100844,148668
233,EE,   Estonia,2005,233701,94244,139457
233,EE,   Estonia,2010,217890,87644,130246
233,EE,   Estonia,2015,194664,80024,114640
233,EE,   Estonia,2020,199277,86767,112510
234,FO,   Faroe Islands*,1990,4285,2440,1845
234,FO,   Faroe Islands*,1995,2900,1575,1325
234,FO,   Faroe Islands*,2000,3593,1921,1672
234,FO,   Faroe Islands*,2005,4583,2450,2133
234,FO,   Faroe Islands*,2010,5096,2700,2396
234,FO,   Faroe Islands*,2015,5485,2783,2702
234,FO,   Faroe Islands*,2020,6812,3542,3270
246,FI,   Finland*,1990,63255,31682,31573
246,FI,   Finland*,1995,99729,49575,50154
246,FI,   Finland*,2000,136203,67469,68734
246,FI,   Finland*,2005,192169,96429,95740
246,FI,   Finland*,2010,228481,115105,113376
246,FI,   Finland*,2015,314856,159315,155541
246,FI,   Finland*,2020,386052,198822,187230
352,IS,   Iceland,1990,9584,4248,5336
352,IS,   Iceland,1995,12738,5727,7011
352,IS,   Iceland,2000,15892,7207,8685
352,IS,   Iceland,2005,25492,12413,13079
352,IS,   Iceland,2010,35091,17619,17472
352,IS,   Iceland,2015,39072,19070,20002
352,IS,   Iceland,2020,65424,35716,29708
372,IE,   Ireland,1990,227961,112093,115868
372,IE,   Ireland,1995,226892,108084,118808
372,IE,   Ireland,2000,350552,172959,177593
372,IE,   Ireland,2005,589046,309910,279136
372,IE,   Ireland,2010,730542,360440,370102
372,IE,   Ireland,2015,759256,376338,382918
372,IE,   Ireland,2020,871256,434756,436500
833,IM,   Isle of Man*,1990,34769,16371,18398
833,IM,   Isle of Man*,1995,36886,17548,19338
833,IM,   Isle of Man*,2000,39002,18725,20277
833,IM,   Isle of Man*,2005,41475,20214,21261
833,IM,   Isle of Man*,2010,43447,21361,22086
833,IM,   Isle of Man*,2015,42238,20596,21642
833,IM,   Isle of Man*,2020,43040,20987,22053
428,LV,   Latvia,1990,646007,290800,355207
428,LV,   Latvia,1995,538093,234216,303877
428,LV,   Latvia,2000,430178,177632,252546
428,LV,   Latvia,2005,376725,154745,221980
428,LV,   Latvia,2010,313786,124675,189111
428,LV,   Latvia,2015,265418,104011,161407
428,LV,   Latvia,2020,239422,97022,142400
440,LT,   Lithuania,1990,349258,164585,184673
440,LT,   Lithuania,1995,273587,128641,144946
440,LT,   Lithuania,2000,214311,100546,113765
440,LT,   Lithuania,2005,201209,94189,107020
440,LT,   Lithuania,2010,160772,69606,91166
440,LT,   Lithuania,2015,136021,57508,78513
440,LT,   Lithuania,2020,145184,73148,72036
578,NO,   Norway*,1990,192587,99562,93025
578,NO,   Norway*,1995,233302,117222,116080
578,NO,   Norway*,2000,292440,144826,147614
578,NO,   Norway*,2005,361144,176444,184700
578,NO,   Norway*,2010,524601,267235,257366
578,NO,   Norway*,2015,746375,389370,357005
578,NO,   Norway*,2020,852238,439206,413032
752,SE,   Sweden,1990,788767,383085,405682
752,SE,   Sweden,1995,936022,450945,485077
752,SE,   Sweden,2000,1003798,480211,523587
752,SE,   Sweden,2005,1125790,538490,587300
752,SE,   Sweden,2010,1337214,648004,689210
752,SE,   Sweden,2015,1602522,786870,815652
752,SE,   Sweden,2020,2003908,1008006,995902
826,GB,   United Kingdom*,1990,3650286,1756448,1893838
826,GB,   United Kingdom*,1995,4155293,1978711,2176582
826,GB,   United Kingdom*,2000,4730165,2228628,2501537
826,GB,   United Kingdom*,2005,5926156,2818177,3107979
826,GB,   United Kingdom*,2010,7119664,3454456,3665208
826,GB,   United Kingdom*,2015,8406996,4021255,4385741
826,GB,   United Kingdom*,2020,9359587,4464423,4895164
8,AL,   Albania,1990,66013,30579,35434
8,AL,   Albania,1995,71354,33284,38070
8,AL,   Albania,2000,76695,35990,40705
8,AL,   Albania,2005,64739,32993,31746
8,AL,   Albania,2010,52784,26901,25883
8,AL,   Albania,2015,52031,26517,25514
8,AL,   Albania,2020,48810,24908,23902
20,AD,   Andorra,1990,38891,20990,17901
20,AD,   Andorra,1995,44206,23588,20618
20,AD,   Andorra,2000,42147,22093,20054
20,AD,   Andorra,2005,50298,26466,23832
20,AD,   Andorra,2010,52053,27287,24766
20,AD,   Andorra,2015,42264,21485,20779
20,AD,   Andorra,2020,45574,23333,22241
70,BA,   Bosnia and Herzegovina,1990,56000,26538,29462
70,BA,   Bosnia and Herzegovina,1995,69476,33115,36361
70,BA,   Bosnia and Herzegovina,2000,82952,39691,43261
70,BA,   Bosnia and Herzegovina,2005,47287,22481,24806
70,BA,   Bosnia and Herzegovina,2010,38945,18581,20364
70,BA,   Bosnia and Herzegovina,2015,38597,18412,20185
70,BA,   Bosnia and Herzegovina,2020,36042,16880,19162
191,HR,   Croatia,1990,475438,222531,252907
191,HR,   Croatia,1995,674085,315733,358352
191,HR,   Croatia,2000,585298,274823,310475
191,HR,   Croatia,2005,579273,271645,307628
191,HR,   Croatia,2010,573248,268466,304782
191,HR,   Croatia,2015,561093,260473,300620
191,HR,   Croatia,2020,528056,245564,282492
292,GI,   Gibraltar*,1990,8709,4528,4181
292,GI,   Gibraltar*,1995,8381,4196,4185
292,GI,   Gibraltar*,2000,8054,3865,4189
292,GI,   Gibraltar*,2005,9211,4518,4693
292,GI,   Gibraltar*,2010,10369,5171,5198
292,GI,   Gibraltar*,2015,11065,5591,5474
292,GI,   Gibraltar*,2020,11190,5656,5534
300,GR,   Greece,1990,618139,330038,288101
300,GR,   Greece,1995,857850,445004,412846
300,GR,   Greece,2000,1111665,559794,551871
300,GR,   Greece,2005,1190707,587677,603030
300,GR,   Greece,2010,1321149,640731,680418
300,GR,   Greece,2015,1242924,570529,672395
300,GR,   Greece,2020,1340456,642639,697817
336,VA,   Holy See*,1990,762,376,386
336,VA,   Holy See*,1995,778,379,399
336,VA,   Holy See*,2000,790,379,411
336,VA,   Holy See*,2005,798,381,417
336,VA,   Holy See*,2010,783,375,408
336,VA,   Holy See*,2015,790,376,414
336,VA,   Holy See*,2020,809,372,437
380,IT,   Italy,1990,1428219,642414,785805
380,IT,   Italy,1995,1774954,809553,965401
380,IT,   Italy,2000,2121688,976691,1144997
380,IT,   Italy,2005,3954790,1820290,2134500
380,IT,   Italy,2010,5787893,2663889,3124004
380,IT,   Italy,2015,5805328,2637798,3167530
380,IT,   Italy,2020,6386998,2965914,3421084
470,MT,   Malta,1990,15077,7012,8065
470,MT,   Malta,1995,17740,8366,9374
470,MT,   Malta,2000,21521,10289,11232
470,MT,   Malta,2005,24560,11899,12661
470,MT,   Malta,2010,33008,17118,15890
470,MT,   Malta,2015,52642,28332,24310
470,MT,   Malta,2020,114760,66055,48705
499,ME,   Montenegro,1990,..,..,..
499,ME,   Montenegro,1995,..,..,..
499,ME,   Montenegro,2000,..,..,..
499,ME,   Montenegro,2005,..,..,..
499,ME,   Montenegro,2010,78512,31639,46873
499,ME,   Montenegro,2015,71719,28178,43541
499,ME,   Montenegro,2020,70999,27995,43004
807,MK,   North Macedonia,1990,95142,39661,55481
807,MK,   North Macedonia,1995,109343,45581,63762
807,MK,   North Macedonia,2000,125665,52385,73280
807,MK,   North Macedonia,2005,127667,53220,74447
807,MK,   North Macedonia,2010,129701,54067,75634
807,MK,   North Macedonia,2015,130730,54496,76234
807,MK,   North Macedonia,2020,131311,54740,76571
620,PT,   Portugal,1990,435782,209922,225860
620,PT,   Portugal,1995,532822,259337,273485
620,PT,   Portugal,2000,651472,320319,331153
620,PT,   Portugal,2005,771184,376774,394410
620,PT,   Portugal,2010,762825,371536,391289
620,PT,   Portugal,2015,864814,398390,466424
620,PT,   Portugal,2020,1001963,479936,522027
674,SM,   San Marino,1990,3310,1728,1582
674,SM,   San Marino,1995,3659,1940,1719
674,SM,   San Marino,2000,4045,2175,1870
674,SM,   San Marino,2005,4218,2302,1916
674,SM,   San Marino,2010,4880,2761,2119
674,SM,   San Marino,2015,5195,2867,2328
674,SM,   San Marino,2020,5543,2991,2552
688,RS,   Serbia*,1990,99269,46712,52557
688,RS,   Serbia*,1995,870980,390134,480846
688,RS,   Serbia*,2000,977873,437602,540271
688,RS,   Serbia*,2005,854848,383088,471760
688,RS,   Serbia*,2010,826275,364757,461518
688,RS,   Serbia*,2015,807441,355180,452261
688,RS,   Serbia*,2020,823011,362493,460518
705,SI,   Slovenia,1990,178077,89514,88563
705,SI,   Slovenia,1995,174419,90255,84164
705,SI,   Slovenia,2000,214508,114772,99736
705,SI,   Slovenia,2005,217218,116741,100477
705,SI,   Slovenia,2010,253786,145138,108648
705,SI,   Slovenia,2015,237616,134460,103156
705,SI,   Slovenia,2020,277964,162815,115149
724,ES,   Spain*,1990,821605,390448,431157
724,ES,   Spain*,1995,1020067,499114,520953
724,ES,   Spain*,2000,1657285,838058,819227
724,ES,   Spain*,2005,4107226,2140680,1966546
724,ES,   Spain*,2010,6280062,3238234,3041828
724,ES,   Spain*,2015,5891208,2884000,3007208
724,ES,   Spain*,2020,6842202,3272773,3569429
40,AT,   Austria,1990,793239,368287,424952
40,AT,   Austria,1995,894893,423302,471591
40,AT,   Austria,2000,996547,478318,518229
40,AT,   Austria,2005,1127164,538924,588240
40,AT,   Austria,2010,1274901,607191,667710
40,AT,   Austria,2015,1483123,714537,768586
40,AT,   Austria,2020,1738183,848395,889788
56,BE,   Belgium,1990,1280583,654543,626040
56,BE,   Belgium,1995,1288003,651788,636215
56,BE,   Belgium,2000,1268368,636275,632093
56,BE,   Belgium,2005,1248733,620924,627809
56,BE,   Belgium,2010,1503806,726881,776925
56,BE,   Belgium,2015,1783488,869989,913499
56,BE,   Belgium,2020,2005479,984117,1021362
250,FR,   France*,1990,5897267,2999376,2897891
250,FR,   France*,1995,6087993,3046083,3041910
250,FR,   France*,2000,6278718,3092789,3185929
250,FR,   France*,2005,6737600,3300859,3436741
250,FR,   France*,2010,7309986,3554527,3755459
250,FR,   France*,2015,7878338,3808573,4069765
250,FR,   France*,2020,8524876,4130737,4394139
276,DE,   Germany,1990,5936181,3293128,2643053
276,DE,   Germany,1995,7464406,3898397,3566009
276,DE,   Germany,2000,8992631,4503666,4488965
276,DE,   Germany,2005,9402447,4676178,4726269
276,DE,   Germany,2010,9812263,4848689,4963574
276,DE,   Germany,2015,10220418,5037961,5182457
276,DE,   Germany,2020,15762457,7891635,7870822
438,LI,   Liechtenstein,1990,10906,5956,4950
438,LI,   Liechtenstein,1995,13311,7068,6243
438,LI,   Liechtenstein,2000,15483,7980,7503
438,LI,   Liechtenstein,2005,18898,9434,9464
438,LI,   Liechtenstein,2010,22342,10867,11475
438,LI,   Liechtenstein,2015,23799,11605,12194
438,LI,   Liechtenstein,2020,25877,12619,13258
442,LU,   Luxembourg,1990,113795,56062,57733
442,LU,   Luxembourg,1995,126106,62292,63814
442,LU,   Luxembourg,2000,139750,69286,70464
442,LU,   Luxembourg,2005,150618,74951,75667
442,LU,   Luxembourg,2010,163142,81420,81722
442,LU,   Luxembourg,2015,248888,126129,122759
442,LU,   Luxembourg,2020,298062,151653,146409
492,MC,   Monaco,1990,20359,9471,10888
492,MC,   Monaco,1995,21060,9955,11105
492,MC,   Monaco,2000,21787,10458,11329
492,MC,   Monaco,2005,21312,10322,10990
492,MC,   Monaco,2010,21132,10325,10807
492,MC,   Monaco,2015,25983,12599,13384
492,MC,   Monaco,2020,26601,12897,13704
528,NL,   Netherlands*,1990,1182263,592343,589920
528,NL,   Netherlands*,1995,1346164,668236,677928
528,NL,   Netherlands*,2000,1556337,765302,791035
528,NL,   Netherlands*,2005,1736127,843444,892683
528,NL,   Netherlands*,2010,1832510,881264,951246
528,NL,   Netherlands*,2015,1996318,952313,1044005
528,NL,   Netherlands*,2020,2358333,1134404,1223929
756,CH,   Switzerland,1990,1392282,701110,691172
756,CH,   Switzerland,1995,1478829,769043,709786
756,CH,   Switzerland,2000,1570756,841855,728901
756,CH,   Switzerland,2005,1805437,922387,883050
756,CH,   Switzerland,2010,2075182,1005381,1069801
756,CH,   Switzerland,2015,2258196,1103416,1154780
756,CH,   Switzerland,2020,2491249,1222202,1269047
660,AI,   Anguilla*,1990,2570,1258,1312
660,AI,   Anguilla*,1995,3317,1584,1733
660,AI,   Anguilla*,2000,4063,1910,2153
660,AI,   Anguilla*,2005,4684,2210,2474
660,AI,   Anguilla*,2010,5103,2415,2688
660,AI,   Anguilla*,2015,5471,2594,2877
660,AI,   Anguilla*,2020,5715,2706,3009
28,AG,   Antigua and Barbuda,1990,12029,5775,6254
28,AG,   Antigua and Barbuda,1995,17550,8046,9504
28,AG,   Antigua and Barbuda,2000,23071,10316,12755
28,AG,   Antigua and Barbuda,2005,24741,11052,13689
28,AG,   Antigua and Barbuda,2010,26412,11788,14624
28,AG,   Antigua and Barbuda,2015,28082,12524,15558
28,AG,   Antigua and Barbuda,2020,29386,13120,16266
533,AW,   Aruba*,1990,14444,6429,8015
533,AW,   Aruba*,1995,22274,9974,12300
533,AW,   Aruba*,2000,30104,13519,16585
533,AW,   Aruba*,2005,32540,14559,17981
533,AW,   Aruba*,2010,34328,15312,19016
533,AW,   Aruba*,2015,36114,16108,20006
533,AW,   Aruba*,2020,53593,24307,29286
44,BS,   Bahamas,1990,26855,13827,13028
44,BS,   Bahamas,1995,31654,16620,15034
44,BS,   Bahamas,2000,36454,19414,17040
44,BS,   Bahamas,2005,45531,23613,21918
44,BS,   Bahamas,2010,54745,27883,26862
44,BS,   Bahamas,2015,59241,29963,29278
44,BS,   Bahamas,2020,63583,32161,31422
52,BB,   Barbados,1990,24024,10065,13959
52,BB,   Barbados,1995,26224,11235,14989
52,BB,   Barbados,2000,28424,12405,16019
52,BB,   Barbados,2005,30624,13575,17049
52,BB,   Barbados,2010,32825,14746,18079
52,BB,   Barbados,2015,34475,15488,18987
52,BB,   Barbados,2020,34869,15668,19201
535,BQ,"   Bonaire, Sint Eustatius and Saba*",1990,13010,..,..
535,BQ,"   Bonaire, Sint Eustatius and Saba*",1995,15101,..,..
535,BQ,"   Bonaire, Sint Eustatius and Saba*",2000,14387,..,..
535,BQ,"   Bonaire, Sint Eustatius and Saba*",2005,14399,..,..
535,BQ,"   Bonaire, Sint Eustatius and Saba*",2010,20941,..,..
535,BQ,"   Bonaire, Sint Eustatius and Saba*",2015,24571,..,..
535,BQ,"   Bonaire, Sint Eustatius and Saba*",2020,26221,..,..
92,VG,   British Virgin Islands*,1990,8035,4126,3909
92,VG,   British Virgin Islands*,1995,10046,5034,5012
92,VG,   British Virgin Islands*,2000,12958,6386,6572
92,VG,   British Virgin Islands*,2005,15016,7401,7615
92,VG,   British Virgin Islands*,2010,17076,8295,8781
92,VG,   British Virgin Islands*,2015,19535,9413,10122
92,VG,   British Virgin Islands*,2020,22164,10681,11483
136,KY,   Cayman Islands*,1990,9315,4587,4728
136,KY,   Cayman Islands*,1995,12666,6339,6327
136,KY,   Cayman Islands*,2000,19176,9671,9505
136,KY,   Cayman Islands*,2005,20679,10515,10164
136,KY,   Cayman Islands*,2010,24062,12310,11752
136,KY,   Cayman Islands*,2015,26193,13406,12787
136,KY,   Cayman Islands*,2020,29242,15017,14225
192,CU,   Cuba,1990,34555,17278,17277
192,CU,   Cuba,1995,26187,12559,13628
192,CU,   Cuba,2000,18545,8212,10333
192,CU,   Cuba,2005,11693,5152,6541
192,CU,   Cuba,2010,7373,3232,4141
192,CU,   Cuba,2015,4649,2027,2622
192,CU,   Cuba,2020,3024,1312,1712
531,CW,   Curaçao*,1990,..,..,..
531,CW,   Curaçao*,1995,..,..,..
531,CW,   Curaçao*,2000,..,..,..
531,CW,   Curaçao*,2005,..,..,..
531,CW,   Curaçao*,2010,34630,14196,20434
531,CW,   Curaçao*,2015,37611,15467,22144
531,CW,   Curaçao*,2020,57210,24958,32252
212,DM,   Dominica,1990,2519,1309,1210
212,DM,   Dominica,1995,3121,1623,1498
212,DM,   Dominica,2000,3723,1955,1768
212,DM,   Dominica,2005,4744,2491,2253
212,DM,   Dominica,2010,8110,4200,3910
212,DM,   Dominica,2015,8093,4215,3878
212,DM,   Dominica,2020,8284,4314,3970
214,DO,   Dominican Republic,1990,291151,181677,109474
214,DO,   Dominican Republic,1995,323381,198842,124539
214,DO,   Dominican Republic,2000,355611,216008,139603
214,DO,   Dominican Republic,2005,375417,227826,147591
214,DO,   Dominican Republic,2010,395479,239808,155671
214,DO,   Dominican Republic,2015,549289,353448,195841
214,DO,   Dominican Republic,2020,603794,382542,221252
308,GD,   Grenada,1990,4263,2106,2157
308,GD,   Grenada,1995,5544,2746,2798
308,GD,   Grenada,2000,6825,3386,3439
308,GD,   Grenada,2005,6902,3424,3478
308,GD,   Grenada,2010,6980,3463,3517
308,GD,   Grenada,2015,7057,3502,3555
308,GD,   Grenada,2020,7213,3292,3921
312,GP,   Guadeloupe*,1990,65944,32718,33226
312,GP,   Guadeloupe*,1995,74566,36248,38318
312,GP,   Guadeloupe*,2000,83188,39778,43410
312,GP,   Guadeloupe*,2005,89065,41273,47792
312,GP,   Guadeloupe*,2010,94942,42768,52174
312,GP,   Guadeloupe*,2015,90956,38680,52276
312,GP,   Guadeloupe*,2020,90206,37914,52292
332,HT,   Haiti,1990,19084,10606,8478
332,HT,   Haiti,1995,18129,10076,8053
332,HT,   Haiti,2000,17222,9572,7650
332,HT,   Haiti,2005,16360,9093,7267
332,HT,   Haiti,2010,17182,9552,7630
332,HT,   Haiti,2015,18047,10036,8011
332,HT,   Haiti,2020,18884,10499,8385
388,JM,   Jamaica,1990,20475,9981,10494
388,JM,   Jamaica,1995,22713,11242,11471
388,JM,   Jamaica,2000,24952,12503,12449
388,JM,   Jamaica,2005,24284,12248,12036
388,JM,   Jamaica,2010,23677,12024,11653
388,JM,   Jamaica,2015,23165,11765,11400
388,JM,   Jamaica,2020,23629,12008,11621
474,MQ,   Martinique*,1990,38705,19091,19614
474,MQ,   Martinique*,1995,46599,22271,24328
474,MQ,   Martinique*,2000,54492,25451,29041
474,MQ,   Martinique*,2005,57034,25891,31143
474,MQ,   Martinique*,2010,59575,26330,33245
474,MQ,   Martinique*,2015,69174,29432,39742
474,MQ,   Martinique*,2020,68624,29199,39425
500,MS,   Montserrat*,1990,2013,1029,984
500,MS,   Montserrat*,1995,1612,825,787
500,MS,   Montserrat*,2000,1211,622,589
500,MS,   Montserrat*,2005,1244,639,605
500,MS,   Montserrat*,2010,1291,664,627
500,MS,   Montserrat*,2015,1351,696,655
500,MS,   Montserrat*,2020,1379,711,668
630,PR,   Puerto Rico*,1990,321909,153354,168555
630,PR,   Puerto Rico*,1995,338067,160739,177328
630,PR,   Puerto Rico*,2000,355038,168480,186558
630,PR,   Puerto Rico*,2005,352144,166780,185364
630,PR,   Puerto Rico*,2010,304969,142939,162030
630,PR,   Puerto Rico*,2015,280494,130916,149578
630,PR,   Puerto Rico*,2020,247132,114868,132264
652,BL,   Saint Barthélemy*,1990,..,..,..
652,BL,   Saint Barthélemy*,1995,..,..,..
652,BL,   Saint Barthélemy*,2000,..,..,..
652,BL,   Saint Barthélemy*,2005,..,..,..
652,BL,   Saint Barthélemy*,2010,..,..,..
652,BL,   Saint Barthélemy*,2015,..,..,..
652,BL,   Saint Barthélemy*,2020,..,..,..
659,KN,   Saint Kitts and Nevis,1990,3210,1642,1568
659,KN,   Saint Kitts and Nevis,1995,4248,2196,2052
659,KN,   Saint Kitts and Nevis,2000,5871,3068,2803
659,KN,   Saint Kitts and Nevis,2005,6682,3501,3181
659,KN,   Saint Kitts and Nevis,2010,7245,3806,3439
659,KN,   Saint Kitts and Nevis,2015,7443,3916,3527
659,KN,   Saint Kitts and Nevis,2020,7725,4066,3659
662,LC,   Saint Lucia,1990,5305,2618,2687
662,LC,   Saint Lucia,1995,7155,3563,3592
662,LC,   Saint Lucia,2000,9871,4960,4911
662,LC,   Saint Lucia,2005,9839,4841,4998
662,LC,   Saint Lucia,2010,9050,4377,4673
662,LC,   Saint Lucia,2015,8673,4179,4494
662,LC,   Saint Lucia,2020,8338,4004,4334
663,MF,   Saint Martin (French part)*,1990,..,..,..
663,MF,   Saint Martin (French part)*,1995,..,..,..
663,MF,   Saint Martin (French part)*,2000,..,..,..
663,MF,   Saint Martin (French part)*,2005,..,..,..
663,MF,   Saint Martin (French part)*,2010,..,..,..
663,MF,   Saint Martin (French part)*,2015,..,..,..
663,MF,   Saint Martin (French part)*,2020,..,..,..
670,VC,   Saint Vincent and the Grenadines,1990,3970,1928,2042
670,VC,   Saint Vincent and the Grenadines,1995,4135,2011,2124
670,VC,   Saint Vincent and the Grenadines,2000,4307,2099,2208
670,VC,   Saint Vincent and the Grenadines,2005,4436,2198,2238
670,VC,   Saint Vincent and the Grenadines,2010,4569,2302,2267
670,VC,   Saint Vincent and the Grenadines,2015,4637,2355,2282
670,VC,   Saint Vincent and the Grenadines,2020,4738,2443,2295
534,SX,   Sint Maarten (Dutch part)*,1990,..,..,..
534,SX,   Sint Maarten (Dutch part)*,1995,..,..,..
534,SX,   Sint Maarten (Dutch part)*,2000,..,..,..
534,SX,   Sint Maarten (Dutch part)*,2005,13099,6285,6814
534,SX,   Sint Maarten (Dutch part)*,2010,26203,12570,13633
534,SX,   Sint Maarten (Dutch part)*,2015,27295,13077,14218
534,SX,   Sint Maarten (Dutch part)*,2020,28845,13822,15023
780,TT,   Trinidad and Tobago,1990,50666,23528,27138
780,TT,   Trinidad and Tobago,1995,45994,21303,24691
780,TT,   Trinidad and Tobago,2000,41753,19288,22465
780,TT,   Trinidad and Tobago,2005,44812,20647,24165
780,TT,   Trinidad and Tobago,2010,48226,23152,25074
780,TT,   Trinidad and Tobago,2015,50021,24464,25557
780,TT,   Trinidad and Tobago,2020,78849,39179,39670
796,TC,   Turks and Caicos Islands*,1990,5062,2620,2442
796,TC,   Turks and Caicos Islands*,1995,7039,3643,3396
796,TC,   Turks and Caicos Islands*,2000,9015,4665,4350
796,TC,   Turks and Caicos Islands*,2005,13115,6787,6328
796,TC,   Turks and Caicos Islands*,2010,17216,8907,8309
796,TC,   Turks and Caicos Islands*,2015,22723,11759,10964
796,TC,   Turks and Caicos Islands*,2020,25748,13325,12423
850,VI,   United States Virgin Islands*,1990,51970,24824,27146
850,VI,   United States Virgin Islands*,1995,54241,25760,28481
850,VI,   United States Virgin Islands*,2000,56611,26730,29881
850,VI,   United States Virgin Islands*,2005,56647,26726,29921
850,VI,   United States Virgin Islands*,2010,56684,26722,29962
850,VI,   United States Virgin Islands*,2015,56721,26728,29993
850,VI,   United States Virgin Islands*,2020,56753,26744,30009
84,BZ,   Belize,1990,30404,16393,14011
84,BZ,   Belize,1995,33446,17512,15934
84,BZ,   Belize,2000,36488,18631,17857
84,BZ,   Belize,2005,41438,21052,20386
84,BZ,   Belize,2010,46390,23475,22915
84,BZ,   Belize,2015,54615,27473,27142
84,BZ,   Belize,2020,62043,31210,30833
188,CR,   Costa Rica,1990,417628,212173,205455
188,CR,   Costa Rica,1995,364287,184485,179802
188,CR,   Costa Rica,2000,310946,156798,154148
188,CR,   Costa Rica,2005,358398,176445,181953
188,CR,   Costa Rica,2010,405779,196055,209724
188,CR,   Costa Rica,2015,411697,197613,214084
188,CR,   Costa Rica,2020,520729,263636,257093
222,SV,   El Salvador,1990,47360,22218,25142
222,SV,   El Salvador,1995,39537,18564,20973
222,SV,   El Salvador,2000,31713,14909,16804
222,SV,   El Salvador,2005,36029,17034,18995
222,SV,   El Salvador,2010,40342,19157,21185
222,SV,   El Salvador,2015,42059,20006,22053
222,SV,   El Salvador,2020,42767,20344,22423
320,GT,   Guatemala,1990,264257,112615,151642
320,GT,   Guatemala,1995,156188,66913,89275
320,GT,   Guatemala,2000,48119,21211,26908
320,GT,   Guatemala,2005,57214,26048,31166
320,GT,   Guatemala,2010,66386,30919,35467
320,GT,   Guatemala,2015,74852,35728,39124
320,GT,   Guatemala,2020,84311,39916,44395
340,HN,   Honduras,1990,270423,137573,132850
340,HN,   Honduras,1995,149442,76077,73365
340,HN,   Honduras,2000,28461,14581,13880
340,HN,   Honduras,2005,27934,14476,13458
340,HN,   Honduras,2010,27288,14306,12982
340,HN,   Honduras,2015,38330,20123,18207
340,HN,   Honduras,2020,39195,20575,18620
484,MX,   Mexico,1990,695674,348353,347321
484,MX,   Mexico,1995,458549,229589,228960
484,MX,   Mexico,2000,538051,270896,267155
484,MX,   Mexico,2005,712648,359724,352924
484,MX,   Mexico,2010,969710,490779,478931
484,MX,   Mexico,2015,1013691,508232,505459
484,MX,   Mexico,2020,1197624,601509,596115
558,NI,   Nicaragua,1990,41421,20860,20561
558,NI,   Nicaragua,1995,26619,13364,13255
558,NI,   Nicaragua,2000,30389,15423,14966
558,NI,   Nicaragua,2005,34919,17774,17145
558,NI,   Nicaragua,2010,37345,19135,18210
558,NI,   Nicaragua,2015,40261,20723,19538
558,NI,   Nicaragua,2020,42167,21683,20484
591,PA,   Panama,1990,62744,33148,29596
591,PA,   Panama,1995,70848,36740,34108
591,PA,   Panama,2000,83410,42437,40973
591,PA,   Panama,2005,109461,55632,53829
591,PA,   Panama,2010,157788,81203,76585
591,PA,   Panama,2015,184710,94841,89869
591,PA,   Panama,2020,313165,167057,146108
32,AR,   Argentina,1990,1649919,788130,861789
32,AR,   Argentina,1995,1595069,753027,842042
32,AR,   Argentina,2000,1540219,717924,822295
32,AR,   Argentina,2005,1674163,775308,898855
32,AR,   Argentina,2010,1805957,831696,974261
32,AR,   Argentina,2015,2086301,960310,1125991
32,AR,   Argentina,2020,2281728,1062533,1219195
68,BO,   Bolivia (Plurinational State of),1990,73758,37549,36209
68,BO,   Bolivia (Plurinational State of),1995,83598,42806,40792
68,BO,   Bolivia (Plurinational State of),2000,92658,47665,44993
68,BO,   Bolivia (Plurinational State of),2005,107745,56019,51726
68,BO,   Bolivia (Plurinational State of),2010,122846,64380,58466
68,BO,   Bolivia (Plurinational State of),2015,143008,74949,68059
68,BO,   Bolivia (Plurinational State of),2020,164121,85961,78160
76,BR,   Brazil,1990,798517,426147,372370
76,BR,   Brazil,1995,741557,396152,345405
76,BR,   Brazil,2000,684596,366156,318440
76,BR,   Brazil,2005,638582,343019,295563
76,BR,   Brazil,2010,592640,319921,272719
76,BR,   Brazil,2015,710304,383457,326847
76,BR,   Brazil,2020,1079708,582881,496827
152,CL,   Chile,1990,107501,54547,52954
152,CL,   Chile,1995,142417,69632,72785
152,CL,   Chile,2000,177332,84717,92615
152,CL,   Chile,2005,276360,131414,144946
152,CL,   Chile,2010,375388,178111,197277
152,CL,   Chile,2015,639724,319714,320010
152,CL,   Chile,2020,1645015,830073,814942
170,CO,   Colombia,1990,104277,53109,51168
170,CO,   Colombia,1995,106943,54666,52277
170,CO,   Colombia,2000,109609,56223,53386
170,CO,   Colombia,2005,106523,54938,51585
170,CO,   Colombia,2010,130309,68391,61918
170,CO,   Colombia,2015,159407,85158,74249
170,CO,   Colombia,2020,1905393,953735,951658
218,EC,   Ecuador,1990,78663,38531,40132
218,EC,   Ecuador,1995,115093,57879,57214
218,EC,   Ecuador,2000,151523,77227,74296
218,EC,   Ecuador,2005,189893,97472,92421
218,EC,   Ecuador,2010,375253,193497,181756
218,EC,   Ecuador,2015,387513,200352,187161
218,EC,   Ecuador,2020,784787,406860,377927
238,FK,   Falkland Islands (Malvinas)*,1990,855,488,367
238,FK,   Falkland Islands (Malvinas)*,1995,868,510,358
238,FK,   Falkland Islands (Malvinas)*,2000,1067,636,431
238,FK,   Falkland Islands (Malvinas)*,2005,1166,675,491
238,FK,   Falkland Islands (Malvinas)*,2010,1436,807,629
238,FK,   Falkland Islands (Malvinas)*,2015,1571,873,698
238,FK,   Falkland Islands (Malvinas)*,2020,1957,1089,868
254,GF,   French Guiana*,1990,63612,34843,28769
254,GF,   French Guiana*,1995,70131,36869,33262
254,GF,   French Guiana*,2000,76649,38895,37754
254,GF,   French Guiana*,2005,86468,42729,43739
254,GF,   French Guiana*,2010,96288,46564,49724
254,GF,   French Guiana*,2015,106108,50399,55709
254,GF,   French Guiana*,2020,119249,56642,62607
328,GY,   Guyana,1990,4095,2200,1895
328,GY,   Guyana,1995,6352,3405,2947
328,GY,   Guyana,2000,8610,4611,3999
328,GY,   Guyana,2005,10868,5817,5051
328,GY,   Guyana,2010,8182,4530,3652
328,GY,   Guyana,2015,8661,4794,3867
328,GY,   Guyana,2020,31169,14497,16672
600,PY,   Paraguay,1990,195884,102816,93068
600,PY,   Paraguay,1995,186570,97869,88701
600,PY,   Paraguay,2000,176608,92052,84556
600,PY,   Paraguay,2005,168243,87698,80545
600,PY,   Paraguay,2010,160299,83394,76905
600,PY,   Paraguay,2015,156462,81303,75159
600,PY,   Paraguay,2020,169567,88311,81256
604,PE,   Peru,1990,56688,28376,28312
604,PE,   Peru,1995,56732,28062,28670
604,PE,   Peru,2000,66300,32839,33461
604,PE,   Peru,2005,77877,38959,38918
604,PE,   Peru,2010,104706,56097,48609
604,PE,   Peru,2015,154774,91090,63684
604,PE,   Peru,2020,1224519,642404,582115
740,SR,   Suriname,1990,18083,9767,8316
740,SR,   Suriname,1995,22320,12091,10229
740,SR,   Suriname,2000,27506,14938,12568
740,SR,   Suriname,2005,33662,18338,15324
740,SR,   Suriname,2010,39713,21658,18055
740,SR,   Suriname,2015,43127,23544,19583
740,SR,   Suriname,2020,47801,26271,21530
858,UY,   Uruguay,1990,98116,45830,52286
858,UY,   Uruguay,1995,93428,43427,50001
858,UY,   Uruguay,2000,88874,41095,47779
858,UY,   Uruguay,2005,82317,37658,44659
858,UY,   Uruguay,2010,76303,34535,41768
858,UY,   Uruguay,2015,78799,35642,43157
858,UY,   Uruguay,2020,108267,50937,57330
862,VE,   Venezuela (Bolivarian Republic of),1990,1025009,517579,507430
862,VE,   Venezuela (Bolivarian Republic of),1995,1019996,513473,506523
862,VE,   Venezuela (Bolivarian Republic of),2000,1013738,508682,505056
862,VE,   Venezuela (Bolivarian Republic of),2005,1076474,538197,538277
862,VE,   Venezuela (Bolivarian Republic of),2010,1347347,676261,671086
862,VE,   Venezuela (Bolivarian Republic of),2015,1404448,703458,700990
862,VE,   Venezuela (Bolivarian Republic of),2020,1324193,652823,671370
60,BM,   Bermuda*,1990,15683,7557,8126
60,BM,   Bermuda*,1995,16676,8044,8632
60,BM,   Bermuda*,2000,17684,8540,9144
60,BM,   Bermuda*,2005,18108,8783,9325
60,BM,   Bermuda*,2010,18547,9035,9512
60,BM,   Bermuda*,2015,19212,9421,9791
60,BM,   Bermuda*,2020,19739,9724,10015
124,CA,   Canada,1990,4333318,2109652,2223666
124,CA,   Canada,1995,4864778,2356105,2508673
124,CA,   Canada,2000,5511914,2659135,2852779
124,CA,   Canada,2005,6078985,2915838,3163147
124,CA,   Canada,2010,6761226,3236539,3524687
124,CA,   Canada,2015,7428657,3533164,3895493
124,CA,   Canada,2020,8049323,3828361,4220962
304,GL,   Greenland*,1990,9282,6472,2810
304,GL,   Greenland*,1995,7121,4875,2246
304,GL,   Greenland*,2000,6601,4616,1985
304,GL,   Greenland*,2005,6556,4461,2095
304,GL,   Greenland*,2010,6091,4119,1972
304,GL,   Greenland*,2015,6009,3951,2058
304,GL,   Greenland*,2020,5899,3822,2077
666,PM,   Saint Pierre and Miquelon*,1990,1099,560,539
666,PM,   Saint Pierre and Miquelon*,1995,1320,682,638
666,PM,   Saint Pierre and Miquelon*,2000,1458,756,702
666,PM,   Saint Pierre and Miquelon*,2005,1147,597,550
666,PM,   Saint Pierre and Miquelon*,2010,1017,531,486
666,PM,   Saint Pierre and Miquelon*,2015,986,516,470
666,PM,   Saint Pierre and Miquelon*,2020,998,523,475
840,US,   United States of America*,1990,23251026,11372985,11878041
840,US,   United States of America*,1995,28451053,14032159,14418894
840,US,   United States of America*,2000,34814053,17310785,17503268
840,US,   United States of America*,2005,39258293,19614878,19643415
840,US,   United States of America*,2010,44183643,21694169,22489474
840,US,   United States of America*,2015,48178877,23446873,24732004
840,US,   United States of America*,2020,50632836,24478996,26153840
36,AU,   Australia*,1990,3955213,2013196,1942017
36,AU,   Australia*,1995,4153330,2093280,2060050
36,AU,   Australia*,2000,4386250,2189900,2196350
36,AU,   Australia*,2005,4878030,2419190,2458840
36,AU,   Australia*,2010,5882980,2922030,2960950
36,AU,   Australia*,2015,6729730,3343330,3386400
36,AU,   Australia*,2020,7685860,3812187,3873673
554,NZ,   New Zealand*,1990,518047,258223,259824
554,NZ,   New Zealand*,1995,588617,289230,299387
554,NZ,   New Zealand*,2000,678813,329927,348886
554,NZ,   New Zealand*,2005,839952,407690,432262
554,NZ,   New Zealand*,2010,947443,459047,488396
554,NZ,   New Zealand*,2015,1039736,502787,536949
554,NZ,   New Zealand*,2020,1381724,668164,713560
242,FJ,   Fiji,1990,13283,6847,6436
242,FJ,   Fiji,1995,13001,6726,6275
242,FJ,   Fiji,2000,12719,6601,6118
242,FJ,   Fiji,2005,12434,6563,5871
242,FJ,   Fiji,2010,13357,7143,6214
242,FJ,   Fiji,2015,13751,7421,6330
242,FJ,   Fiji,2020,14087,7601,6486
540,NC,   New Caledonia*,1990,37673,20885,16788
540,NC,   New Caledonia*,1995,43662,23908,19754
540,NC,   New Caledonia*,2000,49651,26932,22719
540,NC,   New Caledonia*,2005,55405,29909,25496
540,NC,   New Caledonia*,2010,61158,32886,28272
540,NC,   New Caledonia*,2015,68881,36181,32700
540,NC,   New Caledonia*,2020,73141,38284,34857
598,PG,   Papua New Guinea,1990,33710,19362,14348
598,PG,   Papua New Guinea,1995,33526,19832,13694
598,PG,   Papua New Guinea,2000,26304,15874,10430
598,PG,   Papua New Guinea,2005,29971,17851,12120
598,PG,   Papua New Guinea,2010,30425,18466,11959
598,PG,   Papua New Guinea,2015,30940,18734,12206
598,PG,   Papua New Guinea,2020,31068,18895,12173
90,SB,   Solomon Islands,1990,4226,2349,1877
90,SB,   Solomon Islands,1995,4178,2328,1850
90,SB,   Solomon Islands,2000,3981,2224,1757
90,SB,   Solomon Islands,2005,3271,1830,1441
90,SB,   Solomon Islands,2010,2760,1546,1214
90,SB,   Solomon Islands,2015,2585,1450,1135
90,SB,   Solomon Islands,2020,2520,1415,1105
548,VU,   Vanuatu,1990,2308,1269,1039
548,VU,   Vanuatu,1995,2461,1295,1166
548,VU,   Vanuatu,2000,2626,1320,1306
548,VU,   Vanuatu,2005,2800,1398,1402
548,VU,   Vanuatu,2010,2991,1487,1504
548,VU,   Vanuatu,2015,3186,1583,1603
548,VU,   Vanuatu,2020,3257,1619,1638
316,GU,   Guam*,1990,69755,39364,30391
316,GU,   Guam*,1995,71912,38822,33090
316,GU,   Guam*,2000,74070,38280,35790
316,GU,   Guam*,2005,74743,38602,36141
316,GU,   Guam*,2010,75416,38924,36492
316,GU,   Guam*,2015,76089,39246,36843
316,GU,   Guam*,2020,80472,41508,38964
296,KI,   Kiribati,1990,2162,1107,1055
296,KI,   Kiribati,1995,2223,1139,1084
296,KI,   Kiribati,2000,2283,1188,1095
296,KI,   Kiribati,2005,2487,1312,1175
296,KI,   Kiribati,2010,2868,1512,1356
296,KI,   Kiribati,2015,2919,1539,1380
296,KI,   Kiribati,2020,3126,1650,1476
584,MH,   Marshall Islands,1990,1158,721,437
584,MH,   Marshall Islands,1995,1480,916,564
584,MH,   Marshall Islands,2000,1891,1164,727
584,MH,   Marshall Islands,2005,2417,1485,932
584,MH,   Marshall Islands,2010,3089,1895,1194
584,MH,   Marshall Islands,2015,3284,2011,1273
584,MH,   Marshall Islands,2020,3298,2021,1277
583,FM,   Micronesia (Fed. States of),1990,3685,2099,1586
583,FM,   Micronesia (Fed. States of),1995,3342,2119,1223
583,FM,   Micronesia (Fed. States of),2000,3116,1721,1395
583,FM,   Micronesia (Fed. States of),2005,2905,1565,1340
583,FM,   Micronesia (Fed. States of),2010,2806,1503,1303
583,FM,   Micronesia (Fed. States of),2015,2756,1473,1283
583,FM,   Micronesia (Fed. States of),2020,2832,1515,1317
520,NR,   Nauru,1990,2815,1506,1309
520,NR,   Nauru,1995,2605,1395,1210
520,NR,   Nauru,2000,2394,1283,1111
520,NR,   Nauru,2005,2253,1208,1045
520,NR,   Nauru,2010,906,486,420
520,NR,   Nauru,2015,1833,1037,796
520,NR,   Nauru,2020,2201,1297,904
580,MP,   Northern Mariana Islands*,1990,26593,14261,12332
580,MP,   Northern Mariana Islands*,1995,32376,15847,16529
580,MP,   Northern Mariana Islands*,2000,40122,17387,22735
580,MP,   Northern Mariana Islands*,2005,37542,15977,21565
580,MP,   Northern Mariana Islands*,2010,24168,10223,13945
580,MP,   Northern Mariana Islands*,2015,21648,9100,12548
580,MP,   Northern Mariana Islands*,2020,21843,9183,12660
585,PW,   Palau,1990,2801,1800,1001
585,PW,   Palau,1995,4749,2808,1941
585,PW,   Palau,2000,6310,3905,2405
585,PW,   Palau,2005,6043,3620,2423
585,PW,   Palau,2010,5490,3211,2279
585,PW,   Palau,2015,4937,2996,1941
585,PW,   Palau,2020,5088,2888,2200
16,AS,   American Samoa*,1990,21283,11175,10108
16,AS,   American Samoa*,1995,23098,12037,11061
16,AS,   American Samoa*,2000,24912,12898,12014
16,AS,   American Samoa*,2005,24233,12498,11735
16,AS,   American Samoa*,2010,23555,12098,11457
16,AS,   American Samoa*,2015,23513,11998,11515
16,AS,   American Samoa*,2020,23608,12047,11561
184,CK,   Cook Islands*,1990,2587,1443,1144
184,CK,   Cook Islands*,1995,2686,1497,1189
184,CK,   Cook Islands*,2000,2785,1552,1233
184,CK,   Cook Islands*,2005,3277,1724,1553
184,CK,   Cook Islands*,2010,3769,1895,1874
184,CK,   Cook Islands*,2015,4168,2090,2078
184,CK,   Cook Islands*,2020,4579,2290,2289
258,PF,   French Polynesia*,1990,25830,15444,10386
258,PF,   French Polynesia*,1995,28360,16689,11671
258,PF,   French Polynesia*,2000,30329,17604,12725
258,PF,   French Polynesia*,2005,32286,18405,13881
258,PF,   French Polynesia*,2010,31640,18037,13603
258,PF,   French Polynesia*,2015,30058,17136,12922
258,PF,   French Polynesia*,2020,30081,17150,12931
570,NU,   Niue*,1990,461,245,216
570,NU,   Niue*,1995,480,257,223
570,NU,   Niue*,2000,498,268,230
570,NU,   Niue*,2005,522,282,240
570,NU,   Niue*,2010,589,319,270
570,NU,   Niue*,2015,588,319,269
570,NU,   Niue*,2020,588,319,269
882,WS,   Samoa,1990,3357,1771,1586
882,WS,   Samoa,1995,4694,2451,2243
882,WS,   Samoa,2000,5998,3101,2897
882,WS,   Samoa,2005,5746,2940,2806
882,WS,   Samoa,2010,5122,2594,2528
882,WS,   Samoa,2015,4255,2151,2104
882,WS,   Samoa,2020,4021,2031,1990
772,TK,   Tokelau*,1990,360,196,164
772,TK,   Tokelau*,1995,506,268,238
772,TK,   Tokelau*,2000,712,366,346
772,TK,   Tokelau*,2005,1003,500,503
772,TK,   Tokelau*,2010,1128,543,585
772,TK,   Tokelau*,2015,1185,564,621
772,TK,   Tokelau*,2020,1238,586,652
776,TO,   Tonga,1990,2911,1488,1423
776,TO,   Tonga,1995,3274,1718,1556
776,TO,   Tonga,2000,3684,1981,1703
776,TO,   Tonga,2005,4301,2324,1977
776,TO,   Tonga,2010,4607,2503,2104
776,TO,   Tonga,2015,3954,2158,1796
776,TO,   Tonga,2020,3742,2044,1698
798,TV,   Tuvalu,1990,318,180,138
798,TV,   Tuvalu,1995,263,148,115
798,TV,   Tuvalu,2000,218,121,97
798,TV,   Tuvalu,2005,209,115,94
798,TV,   Tuvalu,2010,220,121,99
798,TV,   Tuvalu,2015,230,126,104
798,TV,   Tuvalu,2020,239,132,107
876,WF,   Wallis and Futuna Islands*,1990,1402,726,676
876,WF,   Wallis and Futuna Islands*,1995,1704,872,832
876,WF,   Wallis and Futuna Islands*,2000,2015,1018,997
876,WF,   Wallis and Futuna Islands*,2005,2191,1107,1084
876,WF,   Wallis and Futuna Islands*,2010,2111,1066,1045
876,WF,   Wallis and Futuna Islands*,2015,2050,1035,1015
876,WF,   Wallis and Futuna Islands*,2020,2040,1030,1010
